Gross, Anat (Noodle)	Female	81	anat_Gross@yahoo.com
Faust, Irene	Female	78	irene.faust@gmail.com
Korpal, Genna	Female	72	genna.korpal@gmail.com
Murphy, Aileen	Female	72	amm1of6@hotmail.com
Coatney, Caroline	Female	68	cgcoatney@gmail.com
Hauser, Kristin (Schwade)	Female	66	mrs.kristinhauser@gmail.com
Wright, Hannah (Hannah)	Female	66	hannahmaewright@gmail.com
Hogan, Melissa (Mel)	Female	62	dupontme@icloud.com
Steinberg, Jessie	Female	61	jessalyn53@gmail.com
Reid, Maggie	Female	60	margaretmreid@gmail.com
Inman, Lauren	Female	59	ldeppe10@gmail.com
Kroll, Hannah	Female	58	15krollh@corjesu.org
Gross, Andrea	Female	56	Andreamarie.gross@gmail.com
Moll, Stephanie	Female	56	stephm1978@gmail.com
MUELLER, KATY	Female	56	kmmuelle@go.olemiss.edu
Gray, Dana	Female	55	dana@slua.org
Mothershead, Kristine	Female	55	lennykristine@yahoo.com
Backer, Anne Marie (Anne Marie)	Female	54	annemaback@gmail.com
Botos, Stephanie	Female	53	sierra.echo.baker@gmail.com
Conover, Colette (Coco)	Female	53	coco@studioconover.com
Gibson, Molly	Female	53	mollykrisann@gmail.com
Druker, Kindall	Female	51	kind2all@gmail.com
Holtmeyer, Taylor	Female	51	tholt2010@comcast.net
Inserra, Katelyn (Katie)	Female	51	15inserk@corjesu.org
Jones, Genevieve (G dawg.)	Female	51	15jonesg@corjesu.org
Milton, Claire (Skittles)	Female	51	clairem4444@yahoo.com
Monson, Hannah	Female	50	hkmonson@gmail.com
Walker, Amanda (Panda)	Female	50	anamandawalker@gmail.com
Gray, Allison	Female	49	afgray84@gmail.com
Janisse, Melanie	Female	48	melanie.janisse07@gmail.com
Hall, Emily	Female	47	emhall20@gmail.com
Mueller, Lindsey	Female	47	lam803@gmail.com
Leathers, Jessica	Female	46	jessicaleathers@gmail.com
Cross, Alexis (Lexie)	Female	45	cross.alexisb@yahoo.com
Millar, Lisa	Female	45	15millal@corjesu.org
Pellegrini, Carolyne	Female	45	16PelleC@corjesu.org
Ruff, Kiersten	Female	45	kiersten.ruff@gmail.com
Hogrebe, Emma (Emma)	Female	44	15hogree@corjesu.org
LIschwe, Rebekah	Female	43	rebekah.lischwe@gmail.com
Smith, Win	Female	41	alwayslineagewin@gmail.com
Cash, Carrie (Cash Money)	Female	40	Cashlit@gmail.com
Keady, Courtney	Female	39	15KeadyC@corjesu.org
Michael, Amy	Female	39	akmichael@yahoo.com
Matteucci, Amanda (Mandi)	Female	38	agracematt@gmail.com
Mills, Megan	Female	38	megemills@gmail.com
Arendt, Catherine (Cat)	Female	34	catherinearendt@gmail.com
Murphy, Tasha	Female	34	T_murphystl@yahoo.com
Dong, Alysia	Female	26	aldong44@gmail.com
Kristensen, Katherine (Katie)	Female	26	katherinekristensen@gmail.com
Murphy, David (D-Murph)	Male	88	dmurph18@yahoo.com
Inman, Greg (ginman)	Male	87	ginman86@gmail.com
Hamilton, Stuart	Male	84	stuemh@gmail.com
Storey, David	Male	83	dstorey65@gmail.com
Gibson, Ben (Shaggy)	Male	80	shaggy0012@gmail.com
Gonzalez, Alex (Gonzo)	Male	80	acgth9@gmail.com
Henroid, John	Male	80	jhenroid@gmail.com
Morris, Tim	Male	80	tmo.morris@gmail.com
Dolan, Chris	Male	77	chrisdolan55@gmail.com
Flynn, Rory	Male	77	rorypatrickflynn@gmail.com
Barnett, Jake	Male	76	jakepbarnett@gmail.com
Golomski, Nathan (Nate)	Male	76	n.golomski@gmail.com
Pagel, Brad	Male	76	bradpagel16@gmail.com
Bauer, Jonathan (Jonathan)	Male	74	jonobauer@gmail.com
Pless, Robert	Male	74	pless@cs.wustl.edu
Vasek, Mike	Male	73	Mike.Vasek@gmail.com
Quinn, Parker	Male	72	pquinn91@gmail.com
Smith, Tim (Tim)	Male	72	tbsmth2@gmail.com
Rekart, Matt	Male	70	matt@minardif1.org
Schisler, Daniel (Dan)	Male	70	dschisler@gmail.com
Taylor, Ben	Male	70	btultimate@gmail.com
Ayres, Alexander	Male	69	aayres3@gmail.com
Brok, Adam	Male	69	adambrok@gmail.com
Bogad, Spencer	Male	68	shbogad@gmail.com
Dietz, Alex	Male	66	alexrdietz@gmail.com
Eggleston, Mike	Male	66	megglest77@gmail.com
Heaney, Michael (Mike)	Male	66	mheaney7@yahoo.com
Jones, Lenny	Male	66	jones@seiumo.org
Lukas, John (Christian)	Male	66	jclukas@wustl.edu
Taylor, Paul	Male	66	ptaylor3@gmail.com
Epley, Ryan (Moose)	Male	65	Epley.Ryan1234@gmail.com
Lee, Jeffrey	Male	65	ying-chiang.j.lee@wustl.edu
Butler, Bryan (Bryan)	Male	64	butlerbryanc@gmail.com
Kolenz, Dan	Male	64	dkolenz@gmail.com
Rambach, Rob	Male	63	rrambach@gmail.com
Cohen, Daniel (Zeus)	Male	62	cohendaniel@wustl.edu
Merzel, Mike	Male	62	michael.merzel@gmail.com
meyer, matt	Male	62	meyermatt22@gmail.com
Piela, Bart	Male	62	bartpiela@gmail.com
Swenson, Ian (Ian)	Male	62	n.swnsn@gmail.com
Becker, Jason	Male	61	jason.w.becker@gmail.com
Alcock, Scott	Male	60	scott@slua.org
Baley, Jamie	Male	60	trackedbysatellites@gmail.com
Bence, Rob	Male	60	robbence@gmail.com
Bethel, Christopher	Male	60	Thraxen@gmail.com
Cammack, Alex	Male	60	ajcammack@gmail.com
Geldmeier, Mark	Male	60	mgeldmeier@earthlink.net
Lischwe, Nathaniel (Nate)	Male	60	nlischwe@gmail.com
Mahieu, Nathaniel (Mahieu)	Male	60	nate@mahie.us
Meshach, McCoy	Male	60	mccoy126@gmail.com
Ramos, Conrad (C-Rad)	Male	60	CRamos14@gmail.com
Stilinovic, Andrew (Stili)	Male	60	stili87@gmail.com
Thomas, Joel	Male	60	dieselmcpheasal@gmail.com
Walsh, John	Male	60	jjwalshstl@hotmail.com
Whitelock, John	Male	60	ltljohn98@sbcglobal.net
Aunins, Ben	Male	59	baunins@wustl.edu
Howard, Trevor	Male	59	trevorlhow@gmail.com
Lachance, Steve (Tornado)	Male	59	steverlachance@gmail.com
Neuhaus, Samuel (Sam)	Male	59	Neuhausx5@charter.net
Ruppert, Vince	Male	59	vince.ruppert@gmail.com
Sandvig, Mark	Male	59	Sandvigmc1@gmail.com
Barzilai, Joseph (Joe)	Male	58	jabber3@gmail.com
Herich, Phillip (Phil)	Male	58	prherich@gmail.com
Moentmann, Allen	Male	58	allenmoentmann@yahoo.com
Robey, Jason	Male	58	jasontrobey@gmail.com
Worth, Dan	Male	58	ddworth@gmail.com
Brenner, Daniel (Dani)	Male	57	danibren@gmail.com
Angell, Mike	Male	56	angellmike@gmail.com
Burford, Ben (Ben)	Male	56	jbburf@gmail.com
Cabrera, Anthony	Male	56	acabrera@wustl.edu
Kaskowitz, Louis	Male	56	ldkaskow@gmail.com
Rebillot, Paul	Male	55	p.rebillot3@gmail.com
Farrell, Jacob (Jacob)	Male	54	jacobf140@gmail.com
Frank, Austin (aufrank)	Male	54	aufrank@gmail.com
Hauser, Justen	Male	54	Hausej1@lpha.mopublic.org
Heberlie, Lucas (Heb)	Male	54	heberlie@gmail.com
Holehouse, Alex (alex)	Male	54	alex.holehouse@gmail.com
Jablonowski, Andrew (Jabo)	Male	54	ajabo1113@gmail.com
McGinnis, Kevin	Male	54	mcginnk@gmail.com
reeves, jay	Male	54	jayreeves@rocketmail.com
Barnett, Derrick (Derk)	Male	53	dbarnett500@yahoo.com
Gong, Andrew	Male	53	andrewgong0708@gmail.com
Thurau, Michael	Male	53	laconic2@gmail.com
Tompkins, Charles	Male	53	charles.henri.tompkins@gmail.com
Schnurbusch, Sam (Moses)	Male	52	schnurbuschsam@gmail.com
Thompson, James (Allen)	Male	52	XxOtaruxX@gmail.com
Truschel, Jimmy (Jimmy)	Male	52	Jimwt9@gmail.com
Boehme, Joshua (Josh)	Male	51	megiddo47@hotmail.com
Reisman, Matt (Matthew)	Male	51	matthewdreisman@gmail.com
Lorenz, Joe	Male	50	joe.a.lorenz@gmail.com
Montague, Mike	Male	50	mike.j.montague@gmail.com
DePass, Sean	Male	49	sjl.amdg@gmail.com
Jacobson, Brian	Male	49	BMJacobson@gmail.com
Wilson, Alex (Alison)	Male	49	alex.james.wilson@gmail.com
Alberts, Lucas (luke)	Male	48	lucasalberts@gmail.com
bushue, Toney (slider)	Male	48	dodierocks@gmail.com
Hinderliter, Charles	Male	48	charles.hinderliter@gmail.com
Denton, Brian	Male	47	briandenton88@gmail.com
Ordower, Jeff	Male	47	JEFF@ORDOWER.COM
Rybolt, David (Alex)	Male	47	alexrybolt@sbcglobal.net
Banks, Patrick (p banks)	Male	46	banks.pa@gmail.com
Hautly, Shaun (Colonel)	Male	46	shaun@bathtubtuna.com
Meiner, Timmy	Male	45	timothy.meiner@gmail.com
Kennedy, Kyle (Cal)	Male	44	2016397@sluh.org
Spitznagel, Benjamin (Ben)	Male	44	pickleguy856@hotmail.com
Janisse, Josh	Male	42	jjanisse7@gmail.com
Young, Andrew	Male	42	youngandrewlee@gmail.com
Schulz, Tim	Male	41	tim.schulz2@gmail.com
Eberle, Sean	Male	40	jlsneberle@sbcglobal.net
Frerker, Ron	Male	40	rmfrerker@gmail.com
Bott, Andrew (Andrew)	Male	38	andrewgbott@gmail.com
Lin, Jonathan	Male	38	jblin6@gmail.com
Turner, Keith	Male	38	khturner@gmail.com
Jackson, Brett	Male	37	brett.m.jackson@gmail.com
Westlake, Sean	Male	36	westlakes@rush-enterprises.com
Anderson, Ellis (Eli)	Male	35	bowenanderson@hotmail.com
Chung, Will	Male	35	wc2104@gmail.com
Turner, Ryan	Male	34	rturner17@gmail.com
Gunasingham, Jonathan (jon)	Male	29	j.gunasingham@gmail.com
Warnhoff, Kurt	Male	28	kjw879@gmail.com
Lux, Joe	Male	13	2018466@sluh.org
